PX
# .txt file: gradientmap2
8 8
0
@@@ @@@ @@@ @@@ @@@ @@@ @@@ @@@
@@@                         @@@
@@@             ### ###     @@@
@@@             ###         @@@
@@@         ### ### ### ### @@@
@@@             ###         @@@
@@@                         @@@
@@@ @@@ @@@ @@@ @@@ @@@ @@@ @@@

