PX
# .txt file: gradientmap3
8 8
0
@@@ @@@ @@@ @@@ @@@ @@@ @@@ @@@
@@@                         @@@
@@@ ### ### ### ### ###     @@@
@@@                         @@@
@@@     ### ### ### ### ### @@@
@@@             ###         @@@
@@@     ###                 @@@
@@@ @@@ @@@ @@@ @@@ @@@ @@@ @@@

