PX
# .txt file: gradientmap1
8 8
0
@@@ @@@ @@@ @@@ @@@ @@@ @@@ @@@
@@@                         @@@
@@@     ### ### ### ###     @@@
@@@             ###         @@@
@@@ ###     ### ### ### ### @@@
@@@             ###         @@@
@@@                         @@@
@@@ @@@ @@@ @@@ @@@ @@@ @@@ @@@

