PX
# .map file: path_map.map
20 15
255
   -4   -4   -4   -4   -4   -4   -4   -4   -4   -4   -4   -4   -4   -4   -4   -4   -4   -4   -4   -4
   -4   -2   -2   -2   -2   -2   -2   -2   -2   -2   -2   -2   -2   -2   -2   -2   -2   -2   -2   -4
   -4   -2   -2   -2   -3   -3   -3   -3   -3   -3   -3   -3   -3   -3   -3   -2   -2   -2   -2   -4
   -4   -2   -2   -2   -2   -2   -2   -2   -2   -2   -2   -2   -2   -2   -3   -3   -3   -3   -3   -4
   -4   -3   -3   -3   -3   -3   -3   -3   -3   -3   -2   -2   -2   -2   -3   -3   -3   -2   -2   -4
   -4   -1   24   23   22   21   20   19   18   17   16   15   -3   -3   -3   -2   -2   -2   -2   -4
   -4   -2   -3   -3   -3   -3   -3   -3   -3   -3   -3   14   -2   -2   -2   -2   -2   -2   -2   -4
   -4   -2   -3   -3   -3   -3   -3   -3   -3   -3   -3   13   -2   -2   -2   -2   -2   -2   -2   -4
   -4   -2   -3   -3   -3   -3   -3   -3   -3   -3   -3   12   -2   -2   -2   -2   -2   -2   -2   -4
   -4   -2   -2   -2   -2   -2   -2   -2   -2   -3   -3   11   -2   -2   -2   -2   -2   -2   -2   -4
   -4   -3   -3   -3   -3   -3   -3   -3   -2   -3   -3   10   -3   -3   -3   -3   -2   -3   -3   -4
   -4   -2   -2   -2   -2   -2   -2   -2   -2   -2   -3    9   -3   -3   -3   -3   -2   -2   -2   -4
   -4   -2   -2   -2   -2   -2   -2   -2   -2   -2   -3    8   -3   -3   -3   -3   -3   -3   -2   -4
   -4   -2   -2   -2   -2   -2   -2   -2   -2   -2   -3    7    6    5    4    3    2    1    0   -4
   -4   -4   -4   -4   -4   -4   -4   -4   -4   -4   -4   -4   -4   -4   -4   -4   -4   -4   -4   -4
