PX
# .map file: tough_map.map
12 12
255
   -4   -4   -4   -4   -4   -4   -4   -4   -4   -4   -4   -4
   -4   -2   -2   -2   -2   -2   -2   -2   -2   -2   -2   -4
   -4   -2   -2   -3   -2   -2   -2   -3   -3   -3   -2   -4
   -4   -2   -3   -3   -3   -2   -2   -3   -2   -2   -2   -4
   -4   -2   -3   -3   -3   -3   -2   -3   -3   -3   -2   -4
   -4   -2   -3   -3   -2   -2   -2   -3   -2   -2   -2   -4
   -4   -2   -3   -3   -3   -3   -3   -3   -3   -3   -2   -4
   -4   -2   -3   -3   -3   -3   -3   -3   -2   -2   -2   -4
   -4   -2   -2   -2   -2   -3   -3   -2   -3   -2   -2   -4
   -4   -2   -3   -3   -3   -2   -2   -2   -3   -2   -2   -4
   -4   -2   -2   -2   -2   -2   -3    0   -3   -1   -2   -4
   -4   -4   -4   -4   -4   -4   -4   -4   -4   -4   -4   -4
